Nucleotide SurroundingWord2[ ]*[\[\(]NucleoAmino[\)\]][ ]*Preposition Article[ ]*SurroundingWord2[ ]*Nucleotide SurroundingWord2[ ]*[\[\(]NucleoAmino[\)\]]	DNAAcidChange
NucleoAmino SurroundingWord2[ ]*[\[\(]Nucleotide[\)\]][ ]*Preposition Article[ ]*SurroundingWord2[ ]*NucleoAmino SurroundingWord2[ ]*[\[\(]Nucleotide[\)\]]	DNAAcidChange
Nucleotide SurroundingWord2[ ]*BeVerb[ ]*SurroundingWord1 Preposition Nucleotide	DNAAcidChange
Nucleotide BeVerb[ ]*SurroundingWord1 Preposition Article[ ]*Nucleotide	DNAAcidChange
Nucleotide Preposition Article[ ]*normal enzyme Preposition Nucleotide	DNAAcidChange
Nucleotide SurroundingWord2[ ]*SurroundingWord1 Preposition Nucleotide	DNAAcidChange
Nucleotide SurroundingWord1 Preposition Article[ ]*Nucleotide	DNAAcidChange
Nucleotide BeVerb[ ]*SurroundingWord1 Preposition Nucleotide	DNAAcidChange
Nucleotide SurroundingWord2[ ]*Preposition Nucleotide	DNAAcidChange
Nucleotide rather than Article[ ]*normal Nucleotide	DNAAcidChange
Nucleotide Preposition SurroundingWord1 Nucleotide	DNAAcidChange
Nucleotide SurroundingWord1 Preposition Nucleotide	DNAAcidChange
Nucleotide Preposition Article[ ]*Nucleotide	DNAAcidChange
Nucleotide rather than Article[ ]*Nucleotide	DNAAcidChange
Nucleotide[ ]*GreaterThan2Sign[ ]*Nucleotide	DNAAcidChange
Nucleotide[\- ]+Preposition[\- ]+Nucleotide	DNAAcidChange
Nucleotide Preposition the[ ]*Nucleotide	DNAAcidChange
Nucleotide SurroundingWord1 Nucleotide	DNAAcidChange
Nucleotide[ ]*Preposition[ ]*Nucleotide	DNAAcidChange
Nucleotide rather than Nucleotide	DNAAcidChange
AminoAcid SurroundingWord2[ ]*[\[\(]NucleoAmino[\)\]][ ]*Preposition Article[ ]*SurroundingWord2[ ]*AminoAcid SurroundingWord2[ ]*[\[\(]NucleoAmino[\)\]]	ProteinAcidChange
[\[\(]NucleoAmino[\)\]][ ]*Preposition Article[ ]*SurroundingWord2[ ]*[\[\(]NucleoAmino[\)\]]	ProteinAcidChange
AminoAcid[ ]*[\[\(]NucleoAmino[\)\]][ ]*SurroundingWord1 Preposition Article[ ]*AminoAcid[ ]*[\[\(]NucleoAmino[\)\]]	ProteinAcidChange
AminoAcid[ ]*[\[\(]NucleoAmino[\)\]][ ]*SurroundingWord1 Preposition Article[ ]*AminoAcid	ProteinAcidChange
AminoAcid SurroundingWord2[ ]*BeVerb[ ]*SurroundingWord1 Preposition AminoAcid	ProteinAcidChange
AminoAcid BeVerb[ ]*SurroundingWord1 Preposition Article[ ]*AminoAcid	ProteinAcidChange
AminoAcid Preposition Article[ ]*normal enzyme Preposition AminoAcid	ProteinAcidChange
AminoAcid SurroundingWord2[ ]*SurroundingWord1 Preposition AminoAcid	ProteinAcidChange
AminoAcid Preposition Article[ ]*SurroundingWord2[ ]* AminoAcid	ProteinAcidChange
AminoAcid Preposition Article[ ]*SurroundingWord2[ ]*AminoAcid	ProteinAcidChange
AminoAcid SurroundingWord2[ ]*Preposition Article[ ]*AminoAcid	ProteinAcidChange
AminoAcid SurroundingWord1 Preposition Article[ ]*AminoAcid	ProteinAcidChange
AminoAcid BeVerb[ ]*SurroundingWord1 Preposition AminoAcid	ProteinAcidChange
AminoAcid SurroundingWord2[ ]*Preposition AminoAcid	ProteinAcidChange
AminoAcid rather than Article[ ]*normal AminoAcid	ProteinAcidChange
AminoAcid Preposition SurroundingWord1 AminoAcid	ProteinAcidChange
AminoAcid SurroundingWord1 Preposition AminoAcid	ProteinAcidChange
NucleoAmino[ ]*GreaterThan2Sign[ ]*NucleoAmino	ProteinAcidChange
NucleoAmino[\- ]Preposition[\- ]NucleoAmino	ProteinAcidChange
AminoAcid Preposition Article[ ]*AminoAcid	ProteinAcidChange
AminoAcid rather than Article[ ]*AminoAcid	ProteinAcidChange
AminoAcid[ ]*GreaterThan2Sign[ ]*AminoAcid	ProteinAcidChange
AminoAcid[ ]*GreaterThanSign[ ]*AminoAcid	ProteinAcidChange
AminoAcid Preposition the[ ]*AminoAcid	ProteinAcidChange
AminoAcid SurroundingWord1 AminoAcid	ProteinAcidChange
NucleoAmino Preposition NucleoAmino	ProteinAcidChange
AminoAcid[ ]*Preposition[ ]*AminoAcid	ProteinAcidChange
AminoAcid rather than AminoAcid	ProteinAcidChange
AminoAcid/AminoAcid	ProteinAcidChange
