NucleoAllele_wo_A SurroundingWord1 BeVerb SurroundingWord1 Preposition Article[ ]*SurroundingWordhard2[ ]*LocationNum	DNAAllele
NucleoAllele_wo_A SurroundingWord1 Preposition SurroundingWord2[ ]*SurroundingWord2[ ]*LocationNum	DNAAllele
NucleoAllele_wo_A SurroundingWord2[ ]*SurroundingWord1 Preposition SurroundingWord2[ ]*LocationNum	DNAAllele
NucleoAllele_wo_A SurroundingWord2[ ]*SurroundingWord1 Preposition Article[ ]*s[ ]*LocationNum	DNAAllele
NucleoAllele_wo_A[ ]*GreaterThanSign[ ]*Preposition SurroundingWord2[ ]*[-+]{0,2}LocationNum	DNAAllele
NucleoAllele_wo_A SurroundingWord1 Preposition SurroundingWord2[ ]*LatinCapital LocationNum	DNAAllele
NucleoAllele_wo_A missense SurroundingWord2[ ]*Preposition SurroundingWord2[ ]*LocationNum	DNAAllele
NucleoAllele_wo_A Preposition Article[ ]*variant enzyme Preposition Article[ ]*LocationNum	DNAAllele
NucleoAllele_wo_A SurroundingWord1 Preposition Article[ ]*SurroundingWordhard2[ ]*LocationNum	DNAAllele
LocationNum[ ]*Preposition Article[ ]*SurroundingWord2[ ]*Preposition NucleoAllele	DNAAllele
NucleoAllele_wo_A SurroundingWord1 Preposition SurroundingWord2[ ]*[-+]{0,2}LocationNum	DNAAllele
NucleoAllele_wo_A\) SurroundingWord2[ ]*Preposition SurroundingWord2[ ]*LocationNum	DNAAllele
NucleoAllele_wo_A SurroundingWordhard2 Preposition SurroundingWord2[ ]*LocationNum	DNAAllele
NucleoAllele_wo_A Preposition Article[ ]*SurroundingWord2[ ]*LocationAlleleNum	DNAAllele
NucleoAllele_wo_A SurroundingWord2[ ]*Preposition Article[ ]*LocationAlleleNum	DNAAllele
NucleoAllele_wo_A Preposition SurroundingWord2[ ]*SurroundingWord2[ ]*LocationNum	DNAAllele
NucleoAllele_wo_A SurroundingWord2[ ]*Preposition SurroundingWord2[ ]*LocationNum	DNAAllele
NucleoAllele_wo_A Preposition SurroundingWord2[ ]*[-+]{0,2}LocationAlleleNum	DNAAllele
NucleoAllele_wo_A SurroundingWord1 Preposition Article[ ]*LocationAlleleNum	DNAAllele
NucleoAllele_wo_A SurroundingWord1 Preposition SurroundingWord2[ ]*LocationNum	DNAAllele
NucleoAllele_wo_A\) Preposition SurroundingWord3[ ]*LocationAlleleNum	DNAAllele
NucleoAllele_wo_A Preposition SurroundingWord3[ ]*LocationAlleleNum	DNAAllele
LocationAlleleNum[ ]*SurroundingWord1 Preposition NucleoAllele	DNAAllele
NucleoAllele_wo_A_wo_A[ ]*SurroundingWord3[ ]*LocationAlleleNum	DNAAllele
NucleoAllele_wo_A SurroundingWord1 Preposition sites LocationNum	DNAAllele
NucleoAllele_wo_A Preposition SurroundingWord3[ ]*LocationNum	DNAAllele
LocationAlleleNum[ ]+SurroundingWord3[ ]+NucleoAllele	DNAAllele
NucleoAllele_wo_A-LatinCapitalLocationNum-LocationNum	DNAAllele
OutsideLocation[ ]*LocationNum[\-\+ ]+LocationNum[ ]*NucleoAllele	DNAAllele
SurroundingWord2[ ]*Preposition SurroundingWord2[ ]*LocationNum[\)\]][ ]*Preposition OutsideLocation[ ]*[\[\(]NucleoAmino[\)\]]	ProteinAllele
NucleoAmino_wo_A SurroundingWord2[ ]*Preposition Article[ ]*SurroundingWordhard2[ ]*LocationNum SurroundingWordhard2	ProteinAllele
NucleoAmino_wo_A[ ]*[\[\(]NucleoAmino[\)\]][ ]*SurroundingWord2[ ]*Preposition SurroundingWord2[ ]*LocationNum	ProteinAllele
AminoAcid SurroundingWord1 Preposition SurroundingWord2[ ]*SurroundingWord2[ ]*LocationNum	ProteinAllele
AminoAcid SurroundingWord2[ ]*SurroundingWord1 Preposition SurroundingWord2[ ]*LocationNum	ProteinAllele
[\[\(]NucleoAmino[\)\]][ ]*SurroundingWord2[ ]*Preposition SurroundingWord2[ ]*LocationNum	ProteinAllele
NucleoAmino_wo_A SurroundingWord2[ ]*Preposition Article[ ]*SurroundingWordhard2[ ]*LocationNum	ProteinAllele
AminoAcid SurroundingWord2[ ]*SurroundingWord1 Preposition Article[ ]*s[ ]*LocationNum	ProteinAllele
NucleoAmino_wo_A SurroundingWord2[ ]*AminoAcid Preposition SurroundingWord2[ ]*LocationNum	ProteinAllele
NucleoAmino_wo_A SurroundingWord1 Preposition Article[ ]*SurroundingWordhard2[ ]*LocationNum	ProteinAllele
NucleoAmino_wo_A SurroundingWord2[ ]*Preposition Article[ ]*LocationNum SurroundingWord2	ProteinAllele
AminoAcid SurroundingWord1 Preposition SurroundingWord2[ ]*LatinCapital LocationNum	ProteinAllele
NucleoAmino_wo_A Preposition SurroundingWord2[ ]*LocationNum Preposition[ ]*LocationNum	ProteinAllele
AminoAcid missense SurroundingWord2[ ]*Preposition SurroundingWord2[ ]*LocationNum	ProteinAllele
AminoAcid Preposition Article[ ]*variant enzyme Preposition Article[ ]*LocationNum	ProteinAllele
NucleoAmino_wo_A SurroundingWord2[ ]*Preposition SurroundingWord2[ ]*LocationNum	ProteinAllele
AminoAcid\) SurroundingWord2[ ]*Preposition SurroundingWord2[ ]*LocationNum	ProteinAllele
AminoAcid SurroundingWordhard2 Preposition SurroundingWord2[ ]*LocationNum	ProteinAllele
AminoAcid Preposition Article[ ]*SurroundingWord2[ ]*LocationAlleleNum	ProteinAllele
AminoAcid Preposition SurroundingWord2[ ]*SurroundingWord2[ ]*LocationNum	ProteinAllele
AminoAcid SurroundingWord2[ ]*Preposition SurroundingWord2[ ]*LocationNum	ProteinAllele
AminoAcid[\)\]][ ]*Preposition Article[ ]*SurroundingWordhard2[ ]*LocationNum	ProteinAllele
AminoAcid[\)\]][ ]*Preposition SurroundingWord2[ ]*LocationAlleleNum	ProteinAllele
AminoAcid SurroundingWord1 Preposition Article[ ]*LocationAlleleNum	ProteinAllele
[\[\(]NucleoAmino[\)\]][ ]*Preposition SurroundingWord3[ ]*LocationNum	ProteinAllele
AminoAcid SurroundingWord1 Preposition SurroundingWord3[ ]*LocationNum	ProteinAllele
AminoAcid Preposition SurroundingWord3[ ]*LocationAlleleNum	ProteinAllele
SurroundingWord3[ ]*LocationNum[ ]*[\[\(]AminoAcid[\)\]]	ProteinAllele
AminoAcid[ ]+SurroundingWord3[ ]+LocationAlleleNum	ProteinAllele
LocationAlleleNum[ ]*AminoAcid[ ]*[\[\(]NucleoAmino[\)\]]	ProteinAllele
LocationAlleleNum[ ]*AminoAcid[ ]*[\[\(]NucleoAmino[\)\]]	ProteinAllele
LocationAlleleNum[ ]+SurroundingWord3[ ]+NucleoAmino	ProteinAllele
LocationAlleleNum[ ]+SurroundingWord3[ ]+AminoAcid	ProteinAllele
