(LocationNum|NumberWord)[\- ]*SurroundingWord2[ ]*VariantType BeVerb SurroundingWord1 VariantType Preposition Article[ ]*LocationNum[A-Z]* domain Preposition SurroundingWordhard2[ ]*LocationNum	DNAMutation
Nucleotide Preposition Nucleotide (SurroundingWord2|SurroundingWord1)[ ]*Preposition Article[ ]*SurroundingWordhard2[ ]*LocationNum[ ]*[\[\(]NucleoAmino[ ]*GreaterThanSign[ ]*NucleoAmino[\)\]]	DNAMutation
Nucleotide SurroundingWord2[ ]*VariantType[, ]*RelativePronouns CausingVerb Article[ ]*VariantType SurroundingWord2[ ]*Preposition SurroundingWordhard2[ ]*LocationNum	DNAMutation
Nucleotide[ ]*[\[\(]Nucleotide[\)\]][ ]*Preposition Nucleotide[ ]*[\[\(]Nucleotide[\)\]][ ]*SurroundingWord2[ ]*Preposition SurroundingWordhard2[ ]*LocationNum	DNAMutation
Nucleotide SurroundingWord2[ ]*VariantType, RelativePronouns CausingVerb Article[ ]*SurroundingWordhard2[ ]*Preposition SurroundingWordhard2[ ]*LocationNum	DNAMutation
Nucleotide[ ]*[\[\(]Nucleotide[\)\]][ ]*Preposition Article[ ]*Nucleotide[ ]*[\[\(]Nucleotide[\)\]][ ]*Preposition SurroundingWordhard2[ ]*LocationNum	DNAMutation
Nucleotide[ ]*[\[\(]Nucleotide[\)\]][ ]*Preposition Nucleotide[ ]*[\[\(]Nucleotide[\)\]][ ]*Preposition Article[ ]*SurroundingWordhard2[ ]*LocationNum	DNAMutation
Nucleotide Preposition Nucleotide Conjunction Nucleotide Preposition Nucleotide SurroundingWord2[ ]*Preposition SurroundingWordhard2[ ]*LocationNum	DNAMutation
VariantType Preposition Article[ ]*coding sequence[ ]*[\[\(]SurroundingWordhard2[ ]*LocationNum Preposition SurroundingWordhard2[ ]*LocationNum[\)\]]	DNAMutation
(LocationNum|NumberWord)[\- ]*SurroundingWord2[ ]*VariantType BeVerb SurroundingWord1 VariantType Preposition SurroundingWordhard2[ ]*LocationNum	DNAMutation
Nucleotide[\- ]+Preposition[\- ]+Nucleotide SurroundingWord1 BeVerb SurroundingWord1 Preposition Article[ ]*SurroundingWordhard2[ ]*LocationNum	DNAMutation
MutationType SurroundingWord2[ ]*Preposition SurroundingWordhard2[ ]*LocationNum[ ]*[\[\(]Nucleotide[ ]*GreaterThanSign[ ]*Nucleotide[\)\]]	DNAMutation
Nucleotide SurroundingWord2[ ]*BeVerb VariantType Preposition SurroundingWordhard2[ ]*LocationNum[ ]*Conjunction[ ]*LocationNum	DNAMutation
(LocationNum|NumberWord)[\- ]*SurroundingWord2[ ]*VariantType (SurroundingWord2|SurroundingWord1) Preposition SurroundingWordhard2[ ]*LocationNum	DNAMutation
Nucleotide VariantType[ ]*Preposition OutsideLocation[ ]*LocationNum[ ]*Preposition SurroundingWordhard2[ ]*LocationNum	DNAMutation
Nucleotide VariantType[ ]*Preposition OutsideLocation[ ]*LocationNum[ ]*Conjunction SurroundingWordhard2[ ]*LocationNum	DNAMutation
VariantType CausingVerb NumberWord additional SurroundingWord2[ ]*Preposition SurroundingWordhard2[ ]*LocationNum	DNAMutation
VariantType Article[ ]*NumberWord SurroundingWord2[ ]*Preposition OutsideLocation[ ]*[\[\(]LocationNum[\)\]]	DNAMutation
Nucleotide Preposition Nucleotide SurroundingWord1 Preposition Article[ ]*SurroundingWordhard2[ ]*LocationNum	DNAMutation
Nucleotide VariantType[ ]*Preposition OutsideLocation[ ]*LocationNum[ ]*[ ]*[\[\(]LocationNum[\)\]]	DNAMutation
VariantType CausingVerb NumberWord SurroundingWord2[ ]*Preposition SurroundingWordhard2[ ]*LocationNum	DNAMutation
VariantType Preposition NumberWord SurroundingWord2[ ]*Preposition SurroundingWordhard2[ ]*LocationNum	DNAMutation
NucleoAllele_wo_A[\- ]+VariantType SurroundingWord2[ ]*Preposition SurroundingWordhard2[ ]*LocationNum	DNAMutation
LocationNum[\- ]+SurroundingWord2[ ]*VariantType[ ]*[\[\(]SurroundingWordhard2[: ]*LocationNum[\)\]]	DNAMutation
NumberWord[\- ]+SurroundingWord2[ ]*VariantType Preposition SurroundingWordhard2[ ]*LocationNum	DNAMutation
VariantType Preposition Nucleotide Preposition Article[ ]*SurroundingWordhard2[ ]*LocationNum	DNAMutation
VariantType SurroundingWord2[ ]*Preposition SurroundingWordhard2[ ]*LocationNum	DNAMutation
Nucleotide VariantType[ ]*Preposition SurroundingWordhard2[ ]*LocationNum	DNAMutation
Nucleotide VariantType[ ]*[\[\(]SurroundingWordhard2[ ]*LocationNum[\)\]]	DNAMutation
VariantType[ ]*NumberWord SurroundingWordhard2[ ]*LocationNum	DNAMutation
LocationNum Nucleotide Preposition Nucleotide	DNAMutation
0Article[ ]*VariantType SurroundingWord2[ ]*Preposition SurroundingWordhard2[ ]*LocationNum[, ]*RelativePronouns Article[ ]* SurroundingWord2[ ]*Preposition AminoAcid[ ]*[\[\(]NucleoAmino[\)\]][ ]*Preposition AminoAcid[ ]*[\[\(]NucleoAmino[\)\]][ ]*CausingVerb Article[ ]*AminoAcid SurroundingWord2[ ]*Preposition AminoAcid	ProteinMutation
AminoAcid SurroundingWord2[ ]*[\[\(]NucleoAmino[\)\]][ ]*Preposition Article[ ]SurroundingWord2[ ]*AminoAcid[ ]*[\[\(]NucleoAmino[\)\]][ ]*Preposition SurroundingWordhard2[ ]*LocationNum	ProteinMutation
(LocationNum|NumberWord)[\- ]*SurroundingWord2[ ]*VariantType[\[\( ]NucleoAmino[ ]*Conjunction[ ]*Preposition[ ]*LocationNum[ ]*Conjunction[ ]*LocationNum SurroundingWord2[\)\]]	ProteinMutation
Article[ ]*AminoAcid[ ]*[\[\(]NucleoAmino[\)\]][ ]*Preposition Article[ ]*AminoAcid[ ]*[\[\(]NucleoAmino[\)\]][ ]*Preposition Article[ ]*SurroundingWordhard2[ ]*LocationNum	ProteinMutation
SurroundingWord2[ ]*Preposition AminoAcid[ ]*[\[\(]NucleoAmino[\)\]][ ]*Preposition AminoAcid[ ]*[\[\(]NucleoAmino[\)\]][ ]*Preposition SurroundingWordhard2[ ]*LocationNum	ProteinMutation
SurroundingWord2[ ]*Preposition SurroundingWordhard2[ ]*LocationNum[ ]*Preposition OutsideLocation[ ]*LocationNum[\[\(]NucleoAmino[ ]*GreaterThanSign[ ]*NucleoAmino[\)\]]	ProteinMutation
AminoAcid Preposition AminoAcid SurroundingWord1 Preposition Article[ ]*SurroundingWordhard2[ ]*LocationNum[ ]*[\[\(]NucleoAmino[ ]*GreaterThanSign[ ]*NucleoAmino[\)\]]	ProteinMutation
SurroundingWord2[ ]*[\[\(]NucleoAmino[\)\]][ ]*Preposition Article[ ]*SurroundingWordhard2[ ]*[\[\(]NucleoAmino[\)\]][ ]*Preposition SurroundingWordhard2[ ]*LocationNum	ProteinMutation
NucleoAmino[ ]*[\[\(]NucleoAmino[\)\]][ ]*Preposition NucleoAmino[ ]*[\[\(]NucleoAmino[\)\]][ ]*SurroundingWord2[ ]*Preposition SurroundingWordhard2[ ]*LocationNum	ProteinMutation
AminoAcid[ ]*[\[\(]NucleoAmino[\)\]][ ]*Preposition AminoAcid[ ]*[\[\(]NucleoAmino[\)\]][ ]*SurroundingWord2[ ]*Preposition SurroundingWordhard2[ ]*LocationNum	ProteinMutation
SurroundingWord2[ ]*Preposition SurroundingWordhard2[ ]*LocationNum[ ]*Preposition OutsideLocation[ ]*[\[\(]NucleoAmino[ ]*GreaterThanSign[ ]*NucleoAmino[\)\]]	ProteinMutation
AminoAcid Preposition AminoAcid SurroundingWord2 Preposition SurroundingWordhard2[ ]*LocationNum[ ]*[\[\(]NucleoAmino[ ]*GreaterThanSign[ ]*NucleoAmino[\)\]]	ProteinMutation
NumberWord[\- ]*SurroundingWord2[ ]*VariantType Preposition Article[ ]*NucleoAmino SurroundingWord2[ ]*Preposition SurroundingWordhard2[ ]*LocationNum	ProteinMutation
AminoAcid[ ]*[\[\(]NucleoAmino[\)\]][ ]*Preposition Article[ ]*AminoAcid[ ]*[\[\(]NucleoAmino[\)\]][ ]*Preposition SurroundingWordhard2[ ]*LocationNum	ProteinMutation
AminoAcid[ ]*[\[\(]NucleoAmino[\)\]][ ]*Preposition AminoAcid[ ]*[\[\(]NucleoAmino[\)\]][ ]*Preposition Article[ ]*SurroundingWordhard2[ ]*LocationNum	ProteinMutation
NucleoAmino[ ]*GreaterThanSign[ ]*NucleoAmino SurroundingWord2[ ]*AminoAcid Preposition AminoAcid Preposition SurroundingWordhard2[ ]*LocationNum	ProteinMutation
LocationNum AminoAcid[ ]*[\[\(]LocationNum[ ]*NucleoAmino[\)\]][ ]*Preposition[ ]*LocationNum[ ]*AminoAcid[ ]*[\[\(]LocationNum[ ]*ucleoAmino[\)\]]	ProteinMutation
MutationType SurroundingWord2[ ]*Preposition SurroundingWordhard2[ ]*LocationNum[ ]*[\[\(]NucleoAmino[ ]*GreaterThanSign[ ]*NucleoAmino[\)\]]	ProteinMutation
[0-9]*[ ]*NucleoAmino VariantType[ ]*[\[\(][0-9]*[ ]*NucleoAmino[\)\]][ ]*SurroundingWord2[ ]*Preposition SurroundingWordhard2[ ]*LocationNum	ProteinMutation
AminoAcid[ ]*[\[\(]NucleoAmino[\)\]][ ]*Preposition AminoAcid[ ]*[\[\(]NucleoAmino[\)\]][ ]*Preposition SurroundingWordhard2[ ]*LocationNum	ProteinMutation
AminoAcid Preposition Article[ ]*SurroundingWordhard2[ ]*AminoAcid Preposition OutsideLocation Preposition SurroundingWordhard2[ ]*LocationNum	ProteinMutation
VariantType Preposition NucleoAmino Preposition Article[ ]*polypyrimidine tract Preposition[ ]*LocationNum Preposition[ ]*LocationNum	ProteinMutation
AminoAcid[ ]*[\[\(]NucleoAmino[\)\]][ ]*(SurroundingWord2|SurroundingWord1) Preposition Article[ ]*AminoAcid Preposition SurroundingWordhard2[ ]*LocationNum	ProteinMutation
NucleoAmino Preposition NucleoAmino SurroundingWord2[ ]*Preposition Article[ ]*SurroundingWordhard2[ ]*LocationNum SurroundingWordhard2	ProteinMutation
NucleoAmino Preposition NucleoAmino SurroundingWord2[ ]*Preposition OutsideLocation[ ]*[\[\(]SurroundingWordhard2[ ]*LocationNum[\)\]]	ProteinMutation
NucleoAmino Preposition NucleoAmino SurroundingWord2[ ]*Preposition OutsideLocation Preposition SurroundingWordhard2[ ]*LocationNum	ProteinMutation
AminoAcid SurroundingWord2[ ]*Preposition Article[ ]*AminoAcid SurroundingWord2[ ]*Preposition SurroundingWordhard2[ ]*LocationNum	ProteinMutation
NucleoAmino SurroundingWord2[ ]*BeVerb VariantType Preposition SurroundingWordhard2[ ]*LocationNum Conjunction[ ]*LocationNum	ProteinMutation
VariantType Preposition NumberWord [a-z]*[ ]*NucleoAmino SurroundingWord2[ ]*Preposition SurroundingWordhard2[ ]*LocationNum	ProteinMutation
AminoAcid Preposition Article[ ]*SurroundingWordhard2[ ]*LocationNum Preposition Article[ ]*codon Preposition AminoAcid	ProteinMutation
AminoAcid SurroundingWord2[ ]*Preposition AminoAcid SurroundingWord2[ ]*Preposition SurroundingWordhard2[ ]*LocationNum	ProteinMutation
LocationNum AminoAcid[ ]*[\[\(]NucleoAmino[\)\]][ ]*Preposition[ ]*LocationNum AminoAcid[ ]*[\[\(]NucleoAmino[\)\]]	ProteinMutation
VariantType Preposition Article[ ]*NucleoAmino SurroundingWord2[ ]*Preposition SurroundingWordhard2[ ]*LocationNum	ProteinMutation
NucleoAmino Preposition NucleoAmino SurroundingWord2[ ]*Preposition Article[ ]*SurroundingWordhard2[ ]*LocationNum	ProteinMutation
AminoAcid Preposition Article[ ]*SurroundingWordhard2[ ]* AminoAcid Preposition SurroundingWordhard2[ ]*LocationNum	ProteinMutation
NucleoAmino Preposition NucleoAmino SurroundingWord2[ ]*Preposition Article[ ]*LocationNum SurroundingWord2	ProteinMutation
NucleoAmino Preposition NucleoAmino (SurroundingWord2|SurroundingWord1) Preposition Article[ ]*SurroundingWordhard2[ ]*LocationNum	ProteinMutation
NucleoAmino[ ]*GreaterThanSign[ ]*NucleoAmino SurroundingWord2[ ]*Preposition SurroundingWordhard2[ ]*LocationNum	ProteinMutation
SurroundingWord2[ ]*Preposition AminoAcid Preposition AminoAcid Preposition SurroundingWordhard2[ ]*LocationNum	ProteinMutation
AminoAcid SurroundingWord2[ ]*Preposition Article[ ]*AminoAcid Preposition SurroundingWordhard2[ ]*LocationNum	ProteinMutation
AminoAcid[ ]*[\[\(]NucleoAmino[\)\]][ ]*Preposition[ ]*LocationNum AminoAcid[ ]*[\[\(]NucleoAmino[\)\]]	ProteinMutation
VariantType Preposition Article[ ]*NucleoAmino Preposition Article[ ]*SurroundingWordhard2[ ]*LocationNum	ProteinMutation
LocationNum AminoAcid[ ]*[\[\(]NucleoAmino[\)\]][ ]*Preposition  AminoAcid[ ]*[\[\(]NucleoAmino[\)\]]	ProteinMutation
SurroundingWord2[ ]*NucleoAmino VariantType Preposition[ ]*LocationNum[ ]*Conjunction[ ]*LocationNum	ProteinMutation
NucleoAmino Preposition NucleoAmino SurroundingWord2[ ]*Preposition SurroundingWordhard2[ ]*LocationNum	ProteinMutation
NucleoAmino VariantType Preposition OutsideLocation[ ]*Conjunction SurroundingWordhard2[ ]*LocationNum	ProteinMutation
AminoAcid Preposition AminoAcid SurroundingWord2[ ]*Preposition SurroundingWordhard2[ ]*LocationNum	ProteinMutation
AminoAcid VariantType \(G\/D\), Article[ ]*LocationNum OutsideLocation SurroundingWordhard2	ProteinMutation
AminoAcid Preposition Article[ ]*AminoAcid Preposition SurroundingWordhard2[ ]*LocationNum	ProteinMutation
VariantType SurroundingWord2[ ]*AminoAcid Preposition SurroundingWordhard2[ ]*LocationNum	ProteinMutation
NucleoAmino VariantType Preposition OutsideLocation[ ]*[\[\(]LocationNum[\)\]]	ProteinMutation
LocationNum[ ]*SurroundingWord2[ ]*NucleoAmino[\- ]Preposition[\- ]NucleoAmino	ProteinMutation
AminoAcid Preposition SurroundingWordhard2[ ]*LocationNum Preposition AminoAcid	ProteinMutation
AminoAcid/AminoAcid Preposition Article[ ]*SurroundingWordhard2[ ]*LocationNum	ProteinMutation
SurroundingWordhard2[ ]*LocationNum(,|) AminoAcid Preposition AminoAcid	ProteinMutation
NucleoAmino VariantType[ ]*[\[\(]SurroundingWordhard2[ ]*LocationNum[\)\]]	ProteinMutation
AminoAcid VariantType[ ]*Preposition SurroundingWordhard2[ ]*LocationNum	ProteinMutation
NucleoAmino VariantType Preposition SurroundingWordhard2[ ]*LocationNum	ProteinMutation
NucleoAmino VariantType SurroundingWordhard2[ ]*LocationNum	ProteinMutation
AminoAcid[ ]*LocationNum VariantType	ProteinMutation
