Nucleotide	([ATCGU]+|[Gg]uanine|[Aa]denine|[Aa]denosine|[Tt]hymine|[Tt]hymidine|[Cc]ytosine|[Cc]ytidine|[Uu]racil|[Uu]ridine)
NucleoAllele_wo_A	([TCGU]|[Gg]uanine|[Aa]denine|[Aa]denosine|[Tt]hymine|[Tt]hymidine|[Cc]ytosine|[Cc]ytidine|[Uu]racil|[Uu]ridine)
NucleoAllele	([ATCGU]|[Gg]uanine|[Aa]denine|[Aa]denosine|[Tt]hymine|[Tt]hymidine|[Cc]ytosine|[Cc]ytidine|[Uu]racil|[Uu]ridine)
NucleoAmino	([ATCGU][ATCGU][ATCGU]|Cys|Ile|Ser|Gln|Met|Asn|Pro|Lys|Asp|Thr|Phe|Ala|Gly|His|Leu|Arg|Trp|Val|Glu|Tyr|CYS|ILE|SER|GLN|MET|ASN|PRO|LYS|ASP|THR|PHE|ALA|GLY|HIS|LEU|ARG|TRP|VAL|GLU|TYR|CYs|ILe|SEr|GLn|MEt|ASn|PRo|LYs|ASp|THr|PHe|ALa|GLy|HIs|LEu|ARg|TRp|VAl|GLu|TYr|[gG]lutamine|[Gg]lutamic acid|[Ll]eucine|[Vv]aline|[Ii]soleucine|[Ll]ysine|[Aa]lanine|[Gg]lycine|[Aa]spartate|[Mm]ethionine|[Tt]hreonine|[Hh]istidine|[Aa]spartic acid|[Aa]rginine|[Aa]sparagine|[Tt]ryptophan|[Pp]roline|[Pp]henylalanine|[Cc]ysteine|[Ss]erine|[Gg]lutamate|[Tt]yrosine|[Ss]top|[Tt]erm|[Ss]top codon|[Tt]ermination codon|[Tt]ermination|[CISQMNPKDTFAGHLRWVEYXU])
NucleoAmino_wo_A	([ATCGU][ATCGU][ATCGU]|Cys|Ile|Ser|Gln|Met|Asn|Pro|Lys|Asp|Thr|Phe|Ala|Gly|His|Leu|Arg|Trp|Val|Glu|Tyr|CYS|ILE|SER|GLN|MET|ASN|PRO|LYS|ASP|THR|PHE|ALA|GLY|HIS|LEU|ARG|TRP|VAL|GLU|TYR|CYs|ILe|SEr|GLn|MEt|ASn|PRo|LYs|ASp|THr|PHe|ALa|GLy|HIs|LEu|ARg|TRp|VAl|GLu|TYr|[gG]lutamine|[Gg]lutamic acid|[Ll]eucine|[Vv]aline|[Ii]soleucine|[Ll]ysine|[Aa]lanine|[Gg]lycine|[Aa]spartate|[Mm]ethionine|[Tt]hreonine|[Hh]istidine|[Aa]spartic acid|[Aa]rginine|[Aa]sparagine|[Tt]ryptophan|[Pp]roline|[Pp]henylalanine|[Cc]ysteine|[Ss]erine|[Gg]lutamate|[Tt]yrosine|[Ss]top|[Tt]erm|[Ss]top codon|[Tt]ermination codon|[Tt]ermination|[CISQMNPKDTFGHLRWVEYXU])
AminoAcid	(Cys|Ile|Ser|Gln|Met|Asn|Pro|Lys|Asp|Thr|Phe|Ala|Gly|His|Leu|Arg|Trp|Val|Glu|Tyr|CYS|ILE|SER|GLN|MET|ASN|PRO|LYS|ASP|THR|PHE|ALA|GLY|HIS|LEU|ARG|TRP|VAL|GLU|TYR|CYs|ILe|SEr|GLn|MEt|ASn|PRo|LYs|ASp|THr|PHe|ALa|GLy|HIs|LEu|ARg|TRp|VAl|GLu|TYr|[gG]lutamine|[Gg]lutamic acid|[Ll]eucine|[Vv]aline|[Ii]soleucine|[Ll]ysine|[Aa]lanine|[Gg]lycine|[Aa]spartate|[Mm]ethionine|[Tt]hreonine|[Hh]istidine|[Aa]spartic acid|[Aa]rginine|[Aa]sparagine|[Tt]ryptophan|[Pp]roline|[Pp]henylalanine|[Cc]ysteine|[Ss]erine|[Gg]lutamate|[Tt]yrosine|[Ss]top|[Tt]erm|[Ss]top codon|[Tt]ermination codon|[Tt]ermination|[Ii]nitiation codon|[Ii]nitiation|[Ss]tart|[Ss]tart codon|GLUTAMINE|GLUTAMIC ACID|LEUCINE|VALINE|ISOLEUCINE|LYSINE|ALANINE|GLYCINE|ASPARTATE|METHIONINE|THREONINE|HISTIDINE|ASPARTIC ACID|ARGININE|ASPARAGINE|TRYPTOPHAN|PROLINE|PHENYLALANINE|CYSTEINE|SERINE|GLUTAMATE|TYROSINE)
Preposition	(in|to|into|for|of|by|with|at|locat(e|ed|es)|between|through|rather than|from)
Conjunction	(,|or|and|, and|, or|either)
SurroundingWord1	(start[a-z]*|found|identif[a-z]+|substit[a-z]*|lead[a-z]*|exchang[a-z]*|chang[a-z]*|mutant[a-z]*|mutate[a-z]*|devia[a-z]*|modif[a-z]*|alter[a-z]*|switch[a-z]*|variat[a-z]*|instead[a-z]*|replac[a-z]*|in place|convert[a-z]*|becom[a-z]*|transition|transversion)
SurroundingWord2	(polymorphic|site|point|premature|replacement|replac(e|es|ed|ing)|substitution(s|)|polar|charged|amphipathic|hydrophobic|hydrophilic|frameshift|amino[ \-]acid(s|)|amino|acid(s|)|nucleotide(s|)|mutation(s|)|position(s|)|posi\.|pos\.|islet|liver|base|pair(s|)|bp|bps|bp\.|residue(s|)|radical|codon|aa|nt||tetranucleotide|polymorphism|terminal|allele|cDNA|RNA|mRNA|)[ ]*(polymorphic|site|point|premature|replacement|replac(e|es|ed|ing)|substitution(s|)|polar|charged|amphipathic|hydrophobic|hydrophilic|frameshift|amino[ \-]acid(s|)|amino|acid(s|)|nucleotide(s|)|mutation(s|)|position(s|)|posi\.|pos\.|islet|liver|base|pair(s|)|bp|bps|bp\.|residue(s|)|radical|codon|aa|nt|tetranucleotide|polymorphism|terminal|allele|cDNA|RNA|mRNA|)
SurroundingWord3	(polymorphic|site|point|premature|replacement|replac(e|es|ed|ing)|substitution(s|)|polar|charged|amphipathic|hydrophobic|hydrophilic|frameshift|amino[ \-]acid(s|)|amino|acid(s|)|nucleotide(s|)|mutation(s|)|position(s|)|posi\.|pos\.|islet|liver|base|pair(s|)|bp|bps|bp\.|residue(s|)|radical|codon|aa|nt||tetranucleotide|polymorphism|terminal|allele|cDNA|RNA|mRNA|)[ ]*(polymorphic|site|point|premature|replacement|replac(e|es|ed|ing)|substitution(s|)|polar|charged|amphipathic|hydrophobic|hydrophilic|frameshift|amino[ \-]acid(s|)|amino|acid(s|)|nucleotide(s|)|mutation(s|)|position(s|)|posi\.|pos\.|islet|liver|base|pair(s|)|bp|bps|bp\.|residue(s|)|radical|codon|aa|nt|tetranucleotide|polymorphism|terminal|allele|cDNA|RNA|mRNA)
SurroundingWordhard2	(polymorphic|site|point|premature|replacement|replac(e|es|ed|ing)|substitution(s|)|polar|charged|amphipathic|hydrophobic|hydrophilic|frameshift|amino[ \-]acid(s|)|amino|acid(s|)|nucleotide(s|)|mutation(s|)|position(s|)|posi\.|pos\.|islet|liver|base|pair(s|)|bp|bps|bp\.|residue(s|)|radical|codon|aa|nt|tetranucleotide|polymorphism|terminal|allele|cDNA|RNA|mRNA)[ ]*(polymorphic|site|point|premature|replacement|replac(e|es|ed|ing)|substitution(s|)|polar|charged|amphipathic|hydrophobic|hydrophilic|frameshift|amino[ \-]acid(s|)|amino|acid(s|)|nucleotide(s|)|mutation(s|)|position(s|)|posi\.|pos\.|islet|liver|base|pair(s|)|bp|bps|bp\.|residue(s|)|radical|codon|aa|nt|tetranucleotide|polymorphism|terminal|allele|cDNA|RNA|mRNA|)
BeVerb	((has|have|had) been|is|are|was|were|)
Article	(a|an|the|)
VariantType	(insert(ion|ed|ing|)|duplicat(ion|e|ed|ing)|delet(ion|e|ed|ing)|insertion\/deletion|deletion\/insertion|INS|DEL|INDEL|DELINS|DUP|ins|dup|del|indel|delins|lack(|ed|ing)|los(e|ing|ed)|copy|repeat(|ed))
OutsideLocation	(intron|exon|IVS|3\'UTR|5\'UTR|promoter)[ ]*[\-\+1-9IVX]*
CausingVerb	(caus(e|es|ing)|lead(|s|ing|ed)|encod(e|es|ing|ed)|result(|s|ing|ed)|produc(e|es|ing|ed)|chang(e|es|ing|ed)|covert(|s|ing|ed)|correspond(|s|ing|ed)|predict(|s|ing|ed)|cod(e|es|ing|ed)|concordanc(e|es|ing|ed)|concordant|consist(|s|ing|ed)|encod(e|es|ing|ed)|represent(|s|ing|ed)|led|responsible for|denot(e|es|ing|ed)|designat(e|es|ing|ed)|introduc(e|es|ing|ed)|characteriz(e|es|ing|ed)|bring|involv(e|es|ing|ed)|implicat(e|es|ing|ed)|indicat(e|es|ing|ed)|express(|s|ing|ed)|behav(e|es|ing|ed)|suggest(|s|ing|ed)|impl(y|ies|ed|ying)|presum(e|es|ing|ed))
RelativePronouns	(which|where|what|that)
NumberWord	(single|one|two|three|four|five|six|seven|eight|nine|ten|[0-9]+)
LocationAlleleNum	([-+]*[0-9]+,[0-9]+[0-9]+[0-9]+( (bp(s|)|basepair|basepairs)[ ]*(up|down)stream){0,1}|[\-\+]+[0-9]+|[\_\-\+\/\?0-9]*[0-9][0-9]+)
LocationNum	([-+]*[0-9]+,[0-9]+[0-9]+[0-9]+( (bp(s|)|basepair|basepairs)[ ]*(up|down)stream){0,1}|[\-\+]+[0-9]+|[\_\-\+\/\?0-9]*[0-9\?]+)
LatinCapital	(gamma|alpha|beta|zeta|theta|delta)
MutationType	([Mm]issense|[Nn]onsense|[Nn]onfunctional|[Ss]ilent|[Ss]plice-site)
GreaterThanSign	([-]*>|\(R\)|→|[-]+|\-to\-|\-for\-|to)
GreaterThan2Sign	([-]*>|\(R\)|→|\-to\-|\-for\-|to)
